goods/goodslevel
枚=SLV #money counter. Make coin icon?
家畜=Livestock
魚介類=Seafood
農産物=Produce
加工食品=Processed Food
衣料素材=Fabrics
鉱物素材=Minerals
道具類=Tools
酒類=Liquors
贅沢品=Luxury Items
香料=Spices

gossipinfo/List
最近の噂=New Rumor

menu/Menu
地図=Map
商品=Goods
噂=Rumors
情報=Info
SYS=Menu
購入=Buy
売却=Sell
全選択=All #Select all
戻る=Back
進む=Go #Continue

playerinfo/PlayerInfo
親密度 Lv=Intimacy LVL
商人レベル:=Merchant LVL:
商人経験値:=Trading Exp:
次のレベルUP:=To Next LVL:

title/copyright
(C)支倉凍砂/アスキー・メディアワークス/「狼と香辛料」製作委員会=(C)Isuna Hasekura / ASCII MEDIA WORKS / "Spice & Wolf" Production Committee
(C)2008 「狼どと香辛料」製作委員会/ASCII MEDIA WORKS Inc.=(C)2008 "Spice & Wolf" Production Committee / ASCII MEDIA WORKS Inc.

title/titlemenu
つずきから=Continue
はじめから=New Game
イベントCGを見る=Event CG
オプション=Options
エンディングを見る=Endings
セーブダタ初期化=Reset Save Data

title/titlemenu2
セ一ブ画面へ=View Save Menu
タイトル画面に戻る=Return to Title

Towninfo/Towncommon (bottom 2 boxes)
販売品=For sale:
買値=Buy price
人気の品=Popular items:
売値=Sell price

towninfo/TownInfo01
交易都市 アイマベルグ=Trade City Eimeberg
東西の交通の要所にある、文=A center of business and culture 
化・経済の中心地。近年では=well-placed on the east-west 
正教の教化が進み、教会の支=trading route. In recent years, the 
配下に置かれつつある。=church’s influence over the city has grown.#”Recently,” and “influence” > “control” if too long.

towninfo/TownInfo02
交易都市 クライシュタイン=Trade City Kleistein
西海岸沿いに作られた商業都=A commercial city on the west coast.
市。歴史こそ浅いものの、流=It was built relatively recently,
行に毎感な商人が集まる町と=but has already gained a reputation
してその名を知らしめている。=as a hot-spot for trendy items.

towninfo/TownInfo03
港湾都市 メリンツ=Port Town Melintz
大規模な港を抱えるメリンツ=A gateway for international
は異国への玄関口。遥か外洋=commerce. Crossing the open
を渡ってくる大船団は巨万の=ocean, large convoys continue
富を街にもたらし続けている。=to bring enormous wealth to the city.#”continue to bring enormous wealth in.” if too long.

towninfo/TownInfo04
港湾都市 セアベルク=Port Town Seabelk
西海岸屈指の貿易港。生活に=The foremost port on the west coast.
根ざした輸入品が大量に商わ=Specializing in items for every-
れており、海沿いの酒場には=day life, the seaside pubs are
常に歌と人とがあふれている。=always full of people and song.

towninfo/TownInfo05
地方都市 タルリッヒ=Provincial Town Tallihi
独自の自治と文化を誇る芸術=An artisanal town proud of its
の都。高品質の美術品や調度=unique heritage. People continue
品を求めて工房へと足を運ぶ=to flock to its walls seeking high
人々は古来より後を絶たない。=quality works of art and furnishings.#Cut “works of” if too long.

towninfo/TownInfo06
地方都市 メルス・クリッツ= Provincial Town Mars Kritz
氷に閉ざされる地方との境界=A small trading town on the border
にある小さな交易都市。北の=of a region cut off by ice.
地からもたらされる毛皮や細=Famous for its furs, crafts, and
工品、肉の煮込みが有名。=stewed meats from up north.

towninfo/TownInfo07
要塞都市 ロマネスブルグ=Fortified City Romannesberg 
堅牢な城壁を擁する城塞都市。=A citadel with strong sturdy walls.
異教徒との戦いに赴く軍隊や=Armies and volunteers gather
志願兵たちが篤い信仰心と立=to fight heretics with faith and
身出世を胸に集まってくる。=determination in their hearts.

towninfo/TownInfo08
要塞都市 グラバラス=Fortified City Gravaras
異教の地の要塞都市。異なる=A fortified city in pagan 
文化圏にほど近いため、様々=territory. All manner of
な人や言葉、珍しい産物がめ=people, dialects and rare
まぐるしく行き交っている。=goods can be seen whizzing around.

towninfo/TownInfo09
教会都市 ドルトンク=Parish Town Doltonkh
この地方に於ける正教信仰の=This region's center of faith.
中心地。天高くそびえ立つ大=A towering cathedral welcomes
聖堂は神の威光にふさわしい=visitors with the majesty
荘厳さを以て人々を迎える。=of God's mighty power.

towninfo/TownInfo10
教会都市 クリーグル=Parish Town Kriegel
教会の教えを守り、慎ましく=A town where followers of
暮らす信徒が集まる町。大き=the church live modestly.
な修道院では独自の農法や醸=Research on self-sufficiency
造の研究が日々行われている。=is carried out daily.

towninfo/TownInfo11
漁業都市 ルッシ=Fishing Village Lutz#Technically “Town/city” but I think village sounds more natural in English. “Port” could also work?
古くより漁業で栄える町。特=With a booming fish industry,
産であるニシンの産卵期には=the population swells with 
季節の味を求める旅人たちで=travelers during the spawning 
人口が何倍にもふくれあがる。=period of its renowned herring.
towninfo/TownInfo12
漁業都市 ランドルタット=Fishing Village Landoltatt
島の湾に面した小さな港町。=A small port overlooks the 
干満の差が大きな干潟や岩場=island’s gulf. You can always 
では地物の貝を採る人々の姿=spot people gathering 
が常に見受けられる。=shellfish by the shallow waters.
 
towninfo/TownInfo13
鉱山都市 ヴァルアリー=Mining Town Valerie
古来は銅の採掘で栄え、現在=Having developed a unique
は高い製錬技術で栄える街。=smelting method, orders
大きな鍛冶工房には各地より=for tools and arms come 
農具や武具の注文が相次ぐ。=continuously pouring in.

towninfo/TownInfo14
鉱山都市 シュリンケル=Mining Town Sulinkel
かつては炭坑があったものの=A former coal mine, now 
石炭が枯れた現在は住む者も=empty. The few people who
少ない。山から切り出せる資=who remain rely on the#”rely on resources from the mountain” if room. 
源で細々と生活を営んでいる。=mountain to scrape by.

towninfo/TownInfo15
村ノーリン=Village Norlin
森を切り開いた田園と放牧地=A small village nestled
の中程にたたずむ小さな村。=in greenery. Local specialties
畜産が盛んで、保存の知恵を=include animal-based and
生かした特産品も多数。=preserved goods.#qc I inferred animal products based on the fact livestock rearing is said to be flourishing, might not be accurate.

towninfo/TownInfo16
村 ナウレナス=Village Naulenas
長い街道を旅する人々を癒す=An inn town that makes up
宿場町。華やかな特産こそな=for a lack of fancy specialties
いものの、温かな宿ともてな=with its great hospitality
しはなによりのごちそう。=offered to travelers. #visiting travelers.

towninfo/TownInfo17
村 デッセル=Village Dessel
夕日に映える水車屋が目印=A simple village marked by
の素朴な村。水と緑に恵まれ=a water-wheel mill. Flush with 
た肥沃な土地には広大な麦畑=greenery, it’s home to vast 
と綿花畑が広がっている。=wheat and cotton fields.

towninfo/TownInfo18
村 マールケ=Village Marlke
夏の短い、北の荒涼とした地=A village with a short summer,
に根ざした小さな村。痩せた=in the desolate northern lands.
土地が続く風景は訪れる者に=The endlessly barren terrain 
一抹の寂しさを感じさせる。=leaves visitors feeling empty. 

towninfo/TownInfo19
村 ナインドルハ=Village Neindolha
景観の良高原に作られた村。=A retreat for the leisure class,
有閑階級の保養地として知ら=built on scenic highlands.
れ、木々の間には瀟洒な建物=Elegant buildings and gardens can
と手入れされた庭園が覗く。=be seen hidden amongst the trees.

towninfo/TownInfo20
村 ヴィンヘン=Village Vinchen
農業で栄える小さな村。低地=A small village where
にはアーモンドの花が、ゆる=agriculture thrives.
い丘々に連なる斜面にはブド=Beautiful greenery spreads
ウとオリーブの緑が美しい。=throughout the lands.

towninfo/TownInfo21
村 スウィージ=Village Suize
雪に覆われた連峰の懐にある=Wedged in the snowy mountains,
小さな村。高山のため交通は=travel is difficult, but
不便だが、温泉の療養に遠く=many still come from afar 
から旅してくる者も多い。=for the therapeutic hot springs.

towninfo/TownInfo22
村　ミランド=Village Miland
穏やかな風の吹く静かな集落。=An idyllic village, where the
色とりどりの果樹が立ち並び、=rows of multi-colored fruit trees 
牛や馬がのんびりと草を食む=and peacefully grazing cattle 
光景は昔から変わらない。=remain untouched by time.

towninfo/TownInfo23
故郷　シラ=Historic Village Shila
湖のほとりに面した田舎の村。=A rural village facing a lake.
魚取りの小舟がゆっくりと湖=The sight of small fishing 
面を行き交うさまは、いつ見=boats on the surface of the 
ても心奪われる美しい情景。=lake never fails to captivate.

towninfo/TownInfo24
故郷　エーレ=Historic Village Erle
島の東端にある小さな漁村。=A small fishing village in
稀に美しい二枚貝より採れる=the east. Since ancient times, 
真珠は、海の宝石として古来=the rare pearls found here
より高値で取引されている。=have fetched a high price.

towninfo/TownInfo25
故郷　ワーデン=Historic Village Warden
冬は厚く雪に閉ざされる吹雪=A town which gets snowed
の町。近郊の塩湖よりもたら=in every winter. Occasionally, 
される貴重な食材を求めて訪=merchants come seeking
れる商人の姿を稀に目にする。=valuable salt from the nearby lake.

towninfo/TownInfo26
故郷 ユーベル=Historic Village Yubel
資源を求める人々が新たに切=A village built near newly
り開いた炭坑の近くに作った=opened coal mines.
村。量は少ないものの、質の=Rumor has it that their
良い石炭を産するとの噂。=coal is of high quality.

kaiwa/back/bg_sys_tutorial_01
施設アイコン=Place Icon#refers to the “TownEntranceIcon” image. Maybe we can weasel our way out of having to give it a name?
イベントが発生している施設=Event Scene Available#Indicates that an event is available at this location

kaiwa/back/bg_sys_tutorial_02
酒場=Pub
町の酒場で=Listen to rumors
噂話を間く=at the town pub.
交易マップ=Trade Map#qc Maybe travel map or just map? 
噂話アイコン=Pass by the rumour
を馬車で通る=icon cart via cart
(right)噂話を聞けます=Listen to rumors#Maybe shuffle the text around so “Rumor icon” is on the left, and “Pass by the icon whilst traveling to hear rumors” is on the right?

kaiwa/back/bg_sys_tutorial_03
噂話を間くと…=When you hear a rumor...
新しい町=New towns
が出現=appear
イベント=Events
が発生=occur

kaiwa/back/bg_sys_tutorial_04
商品アイコン=Goods Icon
荷馬車=Cart
購入アイコン=Touch to make a purchase#’Buy Icon’ doesn’t sound quite right.
在庫数=Stock Number#Current Stock
相場目史=Market History
高騰⇈=Up#Maybe shift the images left to make more room for text. Would like to extend these if possible
高値↑=High
同額→=Steady
暴落⇊ =Drop
安値↓=Low

kaiwa/back/bg_sys_tutorial_05
商品名=Goods Name#Item name maybe more natural?
商品ランク=Goods Rank
商品ジャンル=Goods Type
*For the small icons, see goods/goodslevel

kaiwa/back/bg_sys_tutorial_06
商品アイコン=Goods Icon
荷馬車=Cart
売却アイコン=Sell Icon#Again, replace with instructions?
売値=Sell Price
売却数=No. to sell
購入時の値段=Price at time of purchase#Original price paid

kaiwa/back/bg_sys_tutorial_07
(box)販売品=For Sale
(box)買値=Buy Price
買値の平均値=Average Buy Price#Mean Buy Price 
噂を聞いていない=An item you can’t buy as
ので買えない販売品=you haven’t heard the rumor
(box)人気の品=Popular 
(box)買値=Buy Price
売値の平均値=Average Sell Price
所持している=Popular items you own are
人気の品(黄色フチ取り)=indicated by a yellow border

kaiwa/back/sg_bg*
スタッフ=Staff

原作=Original Work
支倉凍砂 (電撃文庫)=Isuna Hasekura (Dengeki Bunko)
原作イラスト=Original Work Illustrations
文倉十=Jyuu Ayakura

キャラクターデザイン=Character Design
黒田和也=Kazuya Kuroda
キャラクター設定=Character Artist
置弓 枷=Kase Okiyumi
田丸 まこと=Makoto Tamaru

背景協力=Background Cooperation
スタジオ美峰=Studio Biho

キャスト=Cast
ホロ=Holo
小清水 亜美=Ami Koshimizu

シュミット=Schmidt
福山 潤=Jun Fukuyama

アニス=Anise
後藤 邑子=Yuuko Gotou
ロウメス=Loumes
鳥海 勝美=Katsumi Toriumi
グスタ=Gusta
中 博史=Hiroshi Naka

サーセン=Sarsen
石川ひろあき=Hiroaki Ishikawa
白熊寬嗣=Hiroshi Shirokuma
菅原淳一=Jun'ichi Sugawara
藤原美央子=Mioko Fujiwara

企画=Planning
吉田 桂一=Keiichi Yoshida
高橋 健二=Kenji Ohba
火野 峻志=Takashi Hino
山根敬洋=Takahiro Yamane

メインストーリー=Main Story
メインシナリオ=Main Scenario
火野 峻志=Takashi Hino

シナリオ=Scenario
山根 敬洋=Takahiro Yamane
有限会社ラムダプランニング=Lambda Planning Co., Ltd
伊藤ヒロ=Hiro Itou
氷鳥隆一=Ryuichi Hitori

スクリプト=Script
山根 敬洋=Takahiro Yamane
火野 峻志=Takashi Hino
氷鳥隆一=Ryuichi Hitori

メインプログラム=Main Programming
山田 晋=Shin Yamada
プログラム=Programming
諸永力=Chikara Moronaga
今橋孝典=Takanori Imahashi

メイングラフィック=Main Graphics
池田 靖爾=Seiji Ikeda
グラフィック=Graphics
田中 幸子=Sachiko Tanaka
伊藤 美和子=Miwako Ito
はしぇめぐ=Meg Hashe

キャラクターグラフイック=Character Art
IMAGIN=Imagin Co., Ltd
イベント原画=Event Art
置弓 枷=Kase Okiyumi
小堺 能夫=Yoshio Kozakai
清水 空翔=Sorato Shimizu
林 あすか=Asuka Hayashi
阿部 可奈子=Kanako Abe
コンポジットディレクター=Composite Director
天花寺伸宏=Tengeji Nobuhiro

サウンド=Sound
福田康文=Yasufumi Fukuda

音響制作=Sound Work
石橋 利香=Rika Ishibashi
(デルファイサウンド)=(Delfi Studio)
収録スタジオ=Recording Studio
a Springスタジオ=a Spring Studio
収録エンジニア=Recording Engineer
神保直史=Naofumi Jinbo
(AUDIO-タナカ)(AUDIO TANAKA)
渡辺基(VOK)=Motoi Watanabe (VOK)
収録コーディネート=Recording Coordinator
桑本 彰弘=Akihiro Kuwamoto
(ぶろだくしょんオバブ)=(Production BAOBAB)

SDホロイラスト=Chibi Holo Art
ゑむ=emu

テーマソング=Theme Song
「隣にいるよ」=“Next To You”
作詞：平野ハイジ=Lyrics: Haiji Hirano
作曲：相澤 大=Composition: Dai Aizawa
編曲：凸 =Arrangement: macado
歌：ホロ(小清水亜美)=Singer: Holo (Ami Koshimizu)

オープニング映像制作=Opening Movie Production
有限会社e-plus digital works Co., Ltd
阿波田 稔子=Toshiko Awata
宣伝=Promotion
藤本 裕子=Yuko Fujimoto
佐々木 健=Takeshi Sasaki
菊池 明菜=Akina Nakamori

営業=Sales
高橋 孝造=Kozo Takahashi
加納 宏樹=Hisako Kanou

制作協力=Production Cooperation
「狼と香辛料」製作委員会="Spice & Wolf" Production Committee
ポニーキャニオン=Pony Canyon Inc.
IMAGIN=Imagin Co., Ltd
電擊文庫編集部=Dengeki Bunko Editorial Department

アシスタント=Assistant
高橋理恵=Rie Takahashi

アシスタント・プロデューサー=Assistant Producer
丸尾 加奈江=Kanae Maruo
荒木 人美=Hitomi Araki

プロデューサー=Producer
宮下 知幸=Tomoyuki Miyashita
徳田 直巳=Naomi Tokuda

統括プロデューサー=General Producer
鈴木 則道=Norimichi Suzuki

制作総指揮=Executive Producer
高野 潔=Kiyoshi Takano

ゲームディレクター=Game Director
高橋 健二=Kenji Ohba

ディレクター=Director
吉田 桂一=Keiichi Yoshida

企画・開発=Planning and Development
热中日和=Netchubiyori

企画・製作=Planning and Production
ASCII MEDIA WORKS
